{
  "levels": [
	{
	  "level": 0,
	  "size": [18, 20],
	  "floor_grid": [
					[0,0,0,0,0,0,0,0,0,0,0,0,0,0,0,0,0,0],
					[0,0,0,0,0,0,0,0,0,0,0,0,0,0,0,0,0,0],
					[0,0,0,0,0,0,0,0,0,0,0,0,0,0,0,0,0,0],
					[0,0,0,0,0,0,0,1,1,0,0,0,0,0,0,0,0,0],
					[0,0,0,0,0,0,0,1,1,0,0,0,0,0,0,0,0,0],
					[0,0,0,0,0,0,0,1,1,0,0,0,0,0,0,0,0,0],
					[0,0,0,0,0,0,0,1,1,1,1,1,1,1,1,1,1,0],
					[0,0,0,0,0,0,0,1,1,1,1,1,1,1,1,1,1,0],
					[0,0,0,0,0,0,0,1,1,0,0,0,0,0,1,1,1,0],
					[0,0,0,0,0,0,0,1,1,0,0,0,0,0,1,1,1,0],
					[0,0,0,0,0,0,0,1,1,0,0,0,0,0,1,1,1,0],
					[0,0,0,0,0,0,0,0,0,0,0,0,0,0,1,1,1,0],
					[0,0,0,0,0,0,0,0,0,0,0,0,0,0,1,1,1,0],
					[0,0,0,0,0,0,0,0,0,0,0,0,0,0,1,1,1,0],
					[0,0,0,0,0,0,0,0,0,0,0,0,0,0,1,1,1,0],
					[0,1,1,1,1,1,1,1,1,1,1,1,1,1,1,1,1,0],
					[0,1,1,1,1,1,1,1,1,1,1,1,1,1,1,1,1,0],
					[0,0,0,0,0,0,0,0,0,0,0,0,0,0,1,1,1,0],
					[0,0,0,0,0,0,0,0,0,0,0,0,0,0,1,1,1,0],
					[0,0,0,0,0,0,0,0,0,0,0,0,0,0,0,0,0,0]
					],
	  "wall_grid": [
					[0,0,0,0,0,0,0,0,0,0,0,0,0,0,0,0,0,0],
					[0,0,0,0,0,0,0,0,0,0,0,0,0,0,0,0,0,0],
					[0,0,0,0,0,0,1,1,1,1,0,0,0,0,0,0,0,0],
					[0,0,0,0,0,0,1,1,1,1,0,0,0,0,0,0,0,0],
					[0,0,0,0,0,0,1,1,1,1,0,0,0,0,0,0,0,0],
					[0,0,0,0,0,0,1,1,1,1,1,1,1,1,1,1,1,1],
					[0,0,0,0,0,0,1,1,1,1,1,1,1,1,1,1,1,1],
					[0,0,0,0,0,0,1,1,1,1,0,0,0,0,0,0,0,1],
					[0,0,0,0,0,0,1,1,1,1,1,1,1,1,0,0,0,1],
					[0,0,0,0,0,0,1,1,1,1,0,0,0,1,0,0,0,1],
					[0,0,0,0,0,0,1,1,1,1,0,0,0,1,0,0,0,1],
					[0,0,0,0,0,0,1,1,1,1,0,0,0,1,0,0,0,1],
					[0,0,0,0,0,0,0,0,0,0,0,0,0,1,0,0,0,1],
					[0,0,0,0,0,0,0,0,0,0,0,0,0,1,0,0,0,1],
					[1,1,1,1,1,1,1,1,1,1,1,1,1,1,1,1,1,1],
					[1,1,1,1,1,1,1,1,1,1,1,1,1,1,1,1,1,1],
					[1,1,1,1,1,1,1,1,1,1,1,1,1,1,1,1,1,1],
					[1,1,1,1,1,1,1,1,1,1,1,1,1,1,1,1,1,1],
					[0,0,0,0,0,0,0,0,0,0,0,0,0,1,1,1,1,1],
					[0,0,0,0,0,0,0,0,0,0,0,0,0,1,1,1,1,1]
					],
	  "doors": [
					[0,0,0,0,0,0,0,0,0,0,0,0,0,0,0,0,0,0],
					[0,0,0,0,0,0,0,0,0,0,0,0,0,0,0,0,0,0],
					[0,0,0,0,0,0,0,0,0,0,0,0,0,0,0,0,0,0],
					[0,0,0,0,0,0,0,0,0,0,0,0,0,0,0,0,0,0],
					[0,0,0,0,0,0,0,0,0,0,0,0,0,0,0,0,0,0],
					[0,0,0,0,0,0,0,0,0,0,0,0,0,0,0,0,0,0],
					[0,0,0,0,0,0,0,0,0,0,0,0,0,0,0,0,0,0],
					[0,0,0,0,0,0,0,0,0,0,0,0,0,0,0,0,0,0],
					[0,0,0,0,0,0,0,0,0,0,0,0,0,0,0,0,0,0],
					[0,0,0,0,0,0,0,0,0,0,0,0,0,0,0,0,0,0],
					[0,0,0,0,0,0,0,0,0,0,0,0,0,0,0,0,0,0],
					[0,0,0,0,0,0,0,0,0,0,0,0,0,0,0,0,0,0],
					[0,0,0,0,0,0,0,0,0,0,0,0,0,0,0,0,0,0],
					[0,0,0,0,0,0,0,0,0,0,0,0,0,0,0,0,0,0],
					[0,1,0,0,1,0,1,0,0,1,0,1,0,0,0,0,0,0],
					[0,0,0,0,0,0,0,0,0,0,0,0,0,0,0,0,0,0],
					[0,0,0,0,0,0,0,0,0,0,0,0,0,0,0,0,0,0],
					[0,0,0,0,1,0,1,0,0,1,0,1,0,0,0,0,0,0],
					[0,0,0,0,0,0,0,0,0,0,0,0,0,0,0,0,0,0],
					[0,0,0,0,0,0,0,0,0,0,0,0,0,0,0,0,0,0],
					],
	},
	{
	  "level": 1,
	  "size": [18, 20],
	  "floor_grid": [
					[0,0,0,0,0,0,0,0,0,0,0,0,0,0,0,0,0,0],
					[0,0,0,0,0,0,0,0,0,0,0,0,0,0,0,0,0,0],
					[0,0,0,0,0,0,0,0,0,1,1,1,1,1,0,0,0,0],
					[0,0,0,0,0,0,0,0,0,0,0,0,1,1,0,0,0,0],
					[0,0,0,0,0,0,0,0,0,0,0,0,1,1,0,0,0,0],
					[0,0,0,0,0,0,0,0,0,0,0,0,1,1,0,0,0,0],
					[0,0,0,0,0,0,0,0,0,1,1,1,1,1,1,1,1,0],
					[0,0,0,0,0,0,0,0,0,1,1,1,1,1,1,1,1,0],
					[0,0,0,0,0,0,0,0,0,0,0,0,1,1,0,0,0,0],
					[0,0,0,0,0,0,0,0,0,0,0,0,1,1,0,0,0,0],
					[0,0,0,0,0,0,0,0,0,0,0,0,1,1,0,0,0,0],
					[0,0,0,0,0,0,0,0,0,0,0,0,1,1,0,0,0,0],
					[0,0,0,0,0,0,0,0,0,0,0,0,1,1,0,0,0,0],
					[0,0,0,0,0,0,0,0,0,0,0,0,1,1,0,0,0,0],
					[0,0,0,0,0,0,0,0,0,0,0,0,1,1,0,0,0,0],
					[0,1,1,1,1,1,1,1,1,1,1,1,1,1,0,0,0,0],
					[0,1,1,1,1,1,1,1,1,1,1,1,1,1,0,0,0,0],
					[0,0,0,0,0,0,0,0,0,0,0,0,0,0,0,0,0,0],
					[0,0,0,0,0,0,0,0,0,0,0,0,0,0,0,0,0,0],
					[0,0,0,0,0,0,0,0,0,0,0,0,0,0,0,0,0,0]
					],
	  "wall_grid": [
					[0,0,0,0,0,0,0,0,0,0,0,0,0,0,0,0,0,0],
					[0,0,0,0,0,0,0,0,0,0,0,0,0,0,0,0,0,0],
					[0,0,0,0,0,0,0,0,0,0,0,0,0,0,0,0,0,0],
					[0,0,0,0,0,0,0,0,0,0,0,1,0,0,0,0,0,0],
					[0,0,0,0,0,0,0,0,0,0,0,1,0,0,0,0,0,0],
					[0,0,0,0,0,0,0,0,1,1,1,1,0,0,0,0,0,0],
					[0,0,0,0,0,0,0,0,1,0,0,0,0,0,0,0,0,0],
					[0,0,0,0,0,0,0,0,1,0,0,0,0,0,0,0,0,0],
					[0,0,0,0,0,0,0,0,1,1,1,1,0,0,0,0,0,0],
					[0,0,0,0,0,0,0,0,0,0,0,1,0,0,0,0,0,0],
					[0,0,0,0,0,0,0,0,0,0,0,1,0,0,0,0,0,0],
					[0,0,0,0,0,0,0,0,0,0,0,1,0,0,0,0,0,0],
					[0,0,0,0,0,0,0,0,0,0,0,1,0,0,0,0,0,0],
					[0,0,0,0,0,0,0,0,0,0,0,1,0,0,0,0,0,0],
					[1,1,1,1,1,1,1,1,1,1,1,1,0,0,0,0,0,0],
					[1,1,1,1,1,1,1,1,0,0,0,0,0,0,0,0,0,0],
					[1,1,1,1,1,1,1,1,0,0,0,0,0,0,0,0,0,0],
					[1,1,1,1,1,1,1,1,1,1,1,1,0,0,0,0,0,0],
					[0,0,0,0,0,0,0,0,0,0,0,0,0,0,0,0,0,0],
					[0,0,0,0,0,0,0,0,0,0,0,0,0,0,0,0,0,0]
					],
		}
	],
		  "stairs": [
				{
					"from": {"level": 1, "x": 16, "y": 8},
					"to":   {"level": 0, "x": 16, "y": 13},
					"orientation": "vertical"
				}
  ]
}
