{
  "levels": [
	{
	  "level": 0,
	  "size": [8, 6],
	  "floor_grid": [
		[0,0,0,0,0,0,0,0],
		[0,0,0,0,0,0,0,0],
		[0,0,1,1,1,1,0,0],
		[0,0,1,1,1,1,0,0],
		[0,0,0,0,0,0,0,0],
		[0,0,0,0,0,0,0,0]
	  ],
	  "wall_grid": [
		[1,1,1,1,1,1,1,1],
		[1,1,1,1,1,1,1,1],
		[1,1,0,0,0,0,1,1],
		[1,1,0,0,0,0,1,1],
		[1,1,1,1,1,1,1,1],
		[1,1,1,1,1,1,1,1]
	  ],
	  "doors": [
		[0,0,0,0,0,0,0,0],
		[0,0,0,1,0,0,0,0],
		[0,0,0,0,0,0,0,0],
		[0,0,0,0,0,0,0,0],
		[0,0,0,0,0,0,0,0],
		[0,0,0,0,0,0,0,0]
	  ]
	}
  ]
}
